############
#     O    #
#     X    #
#     P    #
############
