############
#          #
#    OXP   #
#          #
############
