############
#          #
#    XP    #
#          #
############
