############
#     X    #
#     P    #
#          #
############
