############
#          #
#     PX   #
#          #
############
