############
#          #
#    PXO   #
#          #
############
