############
#          #
#     P    #
#     O   X#
############
