############
#          #
#   PX     #
#          #
############
