############
#          #
#   PXO    #
#          #
############
