############
#          #
#     P    #
#     X    #
############
