############
#     P    #
#     X    #
#     O    #
############
